34410
....oo...o....o.....
.....o..o......o....
o.............o....o
o....oo...o.....oo..
....................
...........o........
..o..............o..
.............o......
............o...o.o.
.o.......o..o....oo.
